⁊	⁊	⁊c,⁊c,⁊c,⁊c,⁊c,⁊cKewethkezyk,⁊c,⁊ctWala,⁊ctMykoron,⁊cMyker,⁊c
à	á	à,raggatwàmynden,à,quàm,à,à,à,à,à,à,oràit
ǎ	á	ǎldoza,Mondǎnak,immǎr,zolǎl,onzollǎkozeek,onzollǎ,monduǎnIgazaan,vrbǎn,parancholǎo̗teth,Vrbǎvalo,Vrbǎn
Ā	Á	Āllʼatok,Ām,Ām,Ārtatlan,Āldott,Āluān̄,Āldott,Ām,Ām,Āron̄,Āldott
ᵃ	a	AueᵃO,A·ᵃO,kateᵃlegh,kateᵃaz,kaᵃalhatatos,Ewangeᵃ{47b}Ez,EwanᵐᵃEz,ewanᵗᵃkenÿweenek,baptᵗᵃ,ewanᵗᵃ,EwaᵐᵃEZ
ā	á	EpistoāZent,EpistoāPal,zolgāiob,monduāCrístusnac,akā--ía,írvāIsay̋as,mārtvam,/Aty̋ā,āuaia,mondvā,y̋madcozvāboÿto̗lvala
a̋	á	kya̋tassal,hoz--za̋m
â	á	mâs
ả	ár	Mảtỉrol,mảtỉnak,immảvronk,čazảmeg,polgảgiermo̗ke,Akả--y̋ok,mảia,mảia,mảia
Æ	ae	Ænnonban,
æ	ae	Ju-dæában,,Galilæa,Nazaræuſnak,prædikálvánJudæa,prædikálvánJudæa,Judæa,és,Galiltæáboͤˊl,Galilæába:,Galilæája,,prædikállani,,Galilæa
ᵇ	b	ewanᵇᵃ
b̄	b	kőnÿvéczkéb̄ꝫ
ć	c	<erćbelo̗l>Harom,ćohoccalko̗veckel,v́dẃo̗-zeÿć,idve-zeÿć,matelukać,azBólćeséget,dićo̗segben,di-ćo̗séo̗ltetik,bẃno̗knekboćianatÿat,boćassadEs,paradićombaMongÿad
č	c	bočatom,čak,bočatandod,čazarnac,čazarnac,čak,čazarnac,čazari,čazarnac,parančoloc,čak
Č	C	Čak
čʼ	c	čʼalard,elkẃlčʼetes,aličʼad,čʼelaiaba,legerkvčʼho̗dben,čʼak,ferenčʼz,:-Ferenčʼz,Ferenčʼzatíank,sinčʼhen,Ferenčʼz
cʼ	c	cʼazar{158v}{158va}Damasws
ᶜ	c	MethᶜᵉAz,MeᶜᵉSemÿnemew,vijmethaᶜᵉ
c̄	c	x̄c̄,íhc̄mínden,íhc̄,ecc̄,Ecc̄,Ec̄c,mondasaatEcc̄,Ec̄c̄ī,Ec̄c̄ī
cᶻ	c	magaztacᶻ,orcᶻaiarul,orcᶻaiat,ercᶻ,felecᶻ,ragacᶻ,magaztacᶻ,veccᶻ,kemencᶻe,orcᶻadnak,orcᶻaiokot
cꝰ	c	tÿthcꝰtanacÿ,henricꝰ,Henricꝰ
dʼ	d	fogadʼ,{78}{39v}faidʼalʼomba
ę	e	dicerę,sę,lennę,Retri--buę{332}{166v}seruo,felel--mę,profetę,imę,ęs,ęs,ęs,ęs
ȩ̇	e	ȩ̇
ȩ	e	ȩ,ȩ,ȩ,ȩ,ȩ,ȩ,ȩ,ȩ
è	e	è,è,è,longè,èféle
ͤ	e	emeztengẏwͤk,zernywͤk,uͤ,kernÿkoͤzTegedet,koͤueſſ,luͤn,luͤn,Huͤtre,Goͤroͤguͤl,Goͤroͤguͤl,Goͤroͤguͤl
Ę	E	Ęz,NIPNĘK,Ęl,Ęz,Ęnnek,Ęnnek,Ęzt,Ęſromot,Ęſrom,Ęleazart,Ęlea-zar
ë	e	gyevhtuën,ÿgëreth,mënd,barbarajmachaga{125}{63r}jdvëz,.>ehezëw,Iſraël,Iſraël,Iſraël,Iſraëlt,Iſraëlnek,Iſraëlnek.{953}[Lk_2][[-]]II.
e̋	e	hallasabane̋bbeen,he̋trendo̗n,ke̋ress,ewee̋,le̋endnek,le̋endnek,le̋endnek,le̋endnek,te̋yend,te̋end,le̋end
ė	e	jelenthetetlėnnagy,vėėz,vėėz,zėėl,zėėl,kėt,kečėgnek,sė,zėnt,ȩ̇
ê	e	kezedbê{111}{56r}Jesus,mêgh
ᵉ	e	MethᶜᵉAz,MeᶜᵉSemÿnemew,vijmethaᶜᵉ,aᵉTyzeno̗tho̗d
ě	é	něuel,temiěnth,ěelo̗,těre,indultatěk,azěrth,teueligěsbo̗l,esměg,vettetuěnvedfel,nězueen,ělo̗istennek
e̗	é	oz-tasse̗c,semíle̗ǵ,e̗g,te̗z,te̗ndo̗nc,le̗g,ze̗p,me̗gaz,Dičo̗se̗g,bizońihtasse̗c,e̗zel
ē	é	ziǵēlyk,engēMert,ennekē<dičeretem>,istēnecfiay̋nac,míndo̗nbēaz,hoǵnē-ha,mikeppēmonǵavolt,hanēnaǵ,Istēnecmíndo̗n,nēto̗rekmeg,remē--sege
ẻ	ér	zokaszẻnth,zemelyezẻnt,miẻhogi,azẻtakaríok,mẻto̗,azẻta,Siluestẻta,AzẻtHarom,okaẻtzero̗ztetek,egízẻ,eretneneko̗kẻk
eᵃ	é	AueᵃO,kateᵃlegh,kateᵃaz,Ewangeᵃ{47b}Ez,KatheᵃHarmad
eͮ	ü	lelkeͮnknek,tewtteͮk,tenneͮk,tenneͮkmeg,teͮttẏk,mẏbenneͮk,ezekkezeͮl,ellenſegiteͮl,erdeggekteͮl,regẏakneͮnec,eͮrdeggegnek
Ǵ	G	Ǵo̗lekezesegbe,Ǵo̗ttret--tetnec,Ǵergel,gerg̋nekǴergÿ,MAǴAR,Ǵalkos,Ǵoͤnoͤruͤſighekben,Ǵalkoſok,Ǵakorta
ḡ	g	maḡt,maḡt,Maḡt,mḡharagottak,mḡsemmieitendik,mḡvtaltal,Mḡkússebeitetted,mḡkemeneggek,aḡki,Chakhoḡh
ḡ	g	m̄ḡkenettem,m̄ḡelegeitette,m̄ḡvizhaltak,m̄ḡbetego̗ltek,m̄ḡ,m̄ḡ,m̄ḡto̗rto̗,m̄ḡ,m̄ḡ{137}en,m̄ḡ{141}kel,halgasdm̄ḡen
ǵ	g	naǵ,hoǵiwtanak,meeǵenghemeth,hoǵ,vaǵ,Hoǵ,hoǵembo̗r,vego̗khoǵ,hoǵ,hoǵ,yǵ
g̋	g	uag̋on,uag̋onko̗zto̗k,hog̋,vg̋an,vg̋an,eg̋,uag̋on,vag̋on,uag̋on,eg̋,eg̋ben
g̈	g	vag̈-ÿok
h̄	h	ih̄sTe,Ih̄ūs,Ih̄ūsnak,Ih̄ūsnak,Ih̄ūs,Ih̄ūsth,Ih̄ūsxp̄ūs,VrāIh̄ūs,Ih̄ūs,Ih̄ūs,Ih̄ūs
hʼ	h	Mathʼas,zilettethʼni,dy̋chʼeseghes,walamaghzathʼa,bochʼata,belchʼ,belchʼeseghebelvagy̋on,belchʼesegh,mutachʼa,aristotilesbelchʼes,Tanachʼot
Ï	i	gon-dolassarolÏgen,ko̗wetko̗zÿk{112r}Ïdwez
ï	i	ïdwezlegÿ,bezedïmethChodaseÿchad,Bet-ſaïdából,mennyeïe-ket,Samariaïakkal.[[10]]Felele,juhaïért.[[12]]A',Romaïak,,Ga-lilæaïak-e,,Krétaïak,és,Arábiaïak:hallottuk,ifiaï-tok
î	i	îlete,Azonkîppen̄,îrt,îrāſāt,îria,îlʼ,mî-zuel,tîghedet,fedelît,buͤnît,îſʒik
ī	i	mīden,mīdvelagot,mīdmeg,mīdo̗n,mīdelfutanac,mīketmeg,mīdmeg,xp̄īna,xp̄īna,xp̄īna,xp̄īna
ỉ	ri	maỉa,Mảtỉrol,mảtỉnak,Maỉalazaar,maỉaTeremtewnknek,maỉaAlazatossagnak,maỉaZyzeknek,maỉa,maỉa,maỉaMynden,maỉa
k̄	k	iromk̄k̄,iromk̄k̄,K̄ek̄mint,fictiokk̄mért
K̄	K	K̄ek̄mint
ᵏ	k	leanᵏ,mōdaᵏ
l̄	l	Capitvl̄,Capltul̄,Capitul̄,Capitul̄,Capitul̄,Evangl̄,Capitul̄,mondaal̄l̄a,mondaal̄l̄a,isrl̄{127}{64r}az,isrel̄t
l̗	l	fol̗ÿre
lʼʼ	l	melʼʼ,olʼʼ,olʼʼ,melʼʼ,olʼʼ,:melʼʼ,Melʼʼ,melʼʼ,olʼʼ,melʼʼ,melʼʼ
Lʼ	L	MELLʼEKET,MELLʼET,MELLʼET,MELLʼET,MELLʼ,OLLʼAN
lʼ	l	melʼto̗keelleto̗s,elʼ,ilʼ,keralʼa,o̗lʼed,emlekezielʼ,zolgalʼon,ilʼen,ilʼ,ńilʼvan,valʼon
ˡ	l	volʳᵒˡharmad
m̄	m	kapitlm̄Az,evangm̄,Evangm̄,Evangem̄,Evangm̄zent,Evanm̄,kapitlm̄·Az,Capm̄,Capm̄,Evangm̄,Evangm̄
ᵐ	m	Mateᵐ,EwanᵐᵃEz,ewanᵐ,Ewanᵐ{112b}[A]Z,Ewanᵐ{113b}[K]Ezdethben,ewaᵐ,ewanᵐ,EwangeᵐAZ,ewanᵐ{129b}Az,EwaᵐᵃEZ,/EwanᵐAZ
ń	n	ko̗ńo̗rólvin,bizońo̗itac,moisesto̗rveńenec,ńomac,meńńet,meńńet,ńomdeka,ko̗ńńen,ko̗ńńen,meńńeknec,meńńeknec
Ń	N	Ńissatok,Ńomorvsag,Ńelvedet,Ńvgoǵatok,Ńelves,Ńomorosagban,Ńeged,Ńolczad,Ńolczadkeńńa,Ńalakcal,Ńilvan
n̈	n	elmn̈-landokrul
n̋	n	men̋e,men̋orz-@@agban,ken̋erho̗z,ken̋erho̗z,tÿkmon̋,ken̋ereeth,men̋orzaag,ken̋er,ke-@@n̋erre,men̋eÿkenernek,hwn̋uan
n̄	n	men̄enek,men̄en,filipen̄,mōn̄ga,alun̄eÿek,o̗an̄ÿanak,vtan̄amasodik,halalhozo̗n̄o̗n,isten̄ekengedno̗m,ÿmeluen̄ÿ,bemen̄e
N̋	N	N̋olczad
ȯ	ó	bucȯzot,köuetkȯzendo,midȯnkeserues,kȯni,kȯnueez{116}{58v}[[]]{117}{59r}Iesus
ō	ó	Capitulō,mōn̄ga,mōd--van,mōd--van,vǵmōdaz,vǵmōdZereto̗,Vǵmōdtouabba,mōd--van,vǵmōdO,esmōdvan,mōd--van
ó̗	ó	elviro̗só̗lvenes,tó̗reben,mennekkó̗,gv́lo̗ló̗m,ió̗io̗n,tó̗t,ǵó̗itven{189v}Kedeg,betó̗kkel,kó̗ueteserv̗l:,edó̗s,felsegó̗s
ô	o	ô,ô
ᵒ	o	p̄dīᵒMíkoron,p̄dícaᵒMínek,p̄díkaᵒO,caᵒxxj,ÿaÿokatcaᵒ,caᵒ,psᵒ,psᵒxxxiij,mÿat{33a}Psᵒ,psᵒ,caᵒ
ó̄	ó	teró̗̄tó̗
ó̗̄	ó	teró̗̄tó̗
ỏ̗	or	embỏ̗vala
ỏ	or	giakỏtameg,haromỏzagoknak,embỏ̗vala,doctỏes,batỏsagnak,doctỏputo,doctỏin,menỏzagba
O̗	Ő	ehnyeiteniO̗to̗d,O̗k,O̗,O̗k,vala{274}{137v}O̗,SimonnakO̗o̗k,.(E)O̗ro̗lieto̗k,O̗to̗d,SO̗t,O̗,O̗
o̗	ő	elo̗,zento̗lo̗,zento̗lo̗,yzo̗ghes,peto̗r,Apastalg(a)bcBo̗ith,Ghergo̗r,Benedo̗k,Gÿmo̗lch,Go̗rgh,peto̗r
ō	ő	lelkō̗bezíuemben,by̋nō̗knec
ō̗	ő	lelkō̗bezíuemben,by̋nō̗knec
ǒ	ő	vǒ̗n,lǒ̗n,kezeibǒ̗l,nembǒ̗l,lǒ̗n,halalbǒl,hǒlt,ÿdǒ̗d,o̗rǒ̗lnek
ǒ̗	ő	vǒ̗n,lǒ̗n,kezeibǒ̗l,nembǒ̗l,lǒ̗n,ÿdǒ̗d,o̗rǒ̗lnek
ō̗	ő	ziksegō̗--nec,o̗rō̗melhozzad,istenō̗--nec,ko̗nÿo̗rogÿō̗k,ennekō̗kellemeto̗sso̗k,fo̗ldō̗valo,ennekō̗,Iduo̗ssego̗nkō̗kih,so̗nnō̗maganak,bēnō̗klakozik,o̗nnō̗magat
oͤ	ö	kernÿkoͤzTegedet,koͤueſſ,Goͤroͤguͤl,Goͤroͤguͤl,Toͤruińin̄,oͤroͤk,oͤroͤk,oͤroͤkkę,oͤroͤkkę,menńboͤl,oͤroͤk
Oͤ	Ö	Oͤtoͤdik,Oͤrdoͤg,Oͤt,Oͤrizznek,Oͤtoͤdik,TOͤrtinęk,Oͤruͤllʼetek,Oͤrdoͤg,Oͤt,Oͤruengetek,Oͤrnuengetek
oͤˊ	ö	koͤˊltoͤzésben.[[12]]És,koͤˊltoͤ-zés-után;,kitoͤˊl,koͤˊltoͤzéſig,,koͤˊltoͤzéſtoͤˊl-fogva,koͤˊltoͤzéſtoͤˊl-fogva,Lélektoͤˊl.,oͤˊtet,oͤˊtet,Lélektoͤˊl,buͤˊnoͤkboͤˊl.
ő̗	ő	ző̗nÿk,kő̗wethsseeghetw̋lNeegÿed,terheebő̗l,ÿdő̗benmÿkoronhallotta,eedesÿdwő̗zeÿtew,ÿdő̗benkÿldeenekel,Ierw--salembő̗l,kó̗ző̗ttetek,kő̗teleet,tő̗rween̋et<.>Azerth,ssebő̗lchesseegheeben
p̄	p	Cap̄,Cap̄Ezeket,Cap̄,Cap̄,Cap̄,Cap̄,Cap̄,Cap̄,Cap̄,xp̄sez,xp̄us
ṕ	p	ciṕanus,ciṕanus,ciṕanusſnaklattatyk,ciṕanusnak,ciṕanus,ciṕanuſtvl,ciṕanus,zentciṕanus
P̄	P	P̄dicacōiaval
ꝓ	pro	ꝓpheta,ꝓpheta,Isaiasꝓpheta,ꝓpheta,ꝓphe--ta,zentꝓfetat,ꝓpfeta,ꝓfetathmÿkeppen,ꝓuincialisthog,ꝓuincialis,ꝓuincialisaz
r̉	r	embo̗r̉eLennie,tenger̉e
ʳ	r	embʳ,embʳ,embʳ,embʳnekennen,barbʳZyz,embʳkepek,doʳOh,volʳᵒˡharmad,doctoʳ
ŕ	r	fŕater,veŕ
ͬ	r	Haͬmadzor
r̄	r	Pr̄nr̄,Pr̄nr̄,pr̄,nr̄,pr̄,nr̄,pr̄sus,§Pr̄,nr̄,pr̄,nr̄{60v}Iesus
R̸	R	R̸ryom,R̸rium,R̸ponſorium,R̸ryomex,R̸orium,R̸ſorium,R̸rium,naponR̸im,R̸ſorium{216}deus,R̸riomot,R̸m{414}Libera
s̄	s	Ias̄,ih̄s̄,xp̄s̄,ihūs̄,Ihūs̄en,Ihūs̄,iehūs̄Cristus,Ihūs̄,vramIhūs̄,vramIhūs̄,xptūs̄
ˢ	s	vezˢ,veezˢ,to̗rzˢ,tezˢ,itilzˢ,hulloviazˢ,valaztazˢ,iarzˢ,iarzˢ,tezˢ,kezˢ
ſ	s	iſtennek,(end)edeſſeges,(end)edeſſeges,irgalmaſſagabol,irgalmaſſagabol,ſeot,ſemmi,iſtenēk,teſtewnknek,eſ,iſtennek
Tʼ	Tj	ATʼāmfiāi,ATʼāmfiai,ATʼāmfiai,ATʼāmfiai
t̄	t	Capit̄,Capit̄,Capit̄,Capit̄,Capit̄,Capit̄,Capit̄,Capit̄,Capit̄,Capit̄,Capit̄
ᵗ	t	ewanᵗᵃkenÿweenek,baptᵗᵃ,ewanᵗᵃ,ewanᵐᵒᵗ:{173a}AZ,ewanᵗᵃ,ewᵗᵃewangeliomrol,engeᵗMert,engeᵗV́gekeziel,engeᵗ,engeᵗMert,engeᵗNincz
tʼʼ	tj	vylagoſoyttʼʼak,thwdhattʼʼok,boczanattʼʼa,akarattʼʼa,yſmerhettʼʼek,tanoyttʼʼa,gondolattʼʼokat,attʼʼathwl,tarttʼʼak,valazttʼʼa,tarttʼʼa
tʼ	tj	zentattʼadnac,peldazattʼara,malazttʼatbevo̗n,malazttʼat,attʼanacbo̗lčesege,ǵalaztʼa,bizońoitʼa,attʼa,akarattʼa,[...]attʼanak,haboritʼav́ket
ủ	u	bonauentủaatÿanknak
ū	ú	Evangeliūoctavaba,Capitūlm,ihū,flebilíūInterpella,purgathoriūba{24r}ennekem,angellū,testamentūzerenth,xp̄ūs,Ih̄ūs,xp̄ūs,urunkxp̄ūs
ǔ	u	iǔtattanak
u̇	ü	fu̇-let,Iu̇uenek,betfagienewu̇,o̗tetu̇to̗th,esku̇dnie,ku̇nyzarmazek,bu̇ne,o̗ru̇leraita,kithu̇l,felu̇l,ku̇lde
uͤ	ü	uͤ,luͤn,luͤn,Huͤtre,Goͤroͤguͤl,uͤ,ſʒuͤeduel,betuͤkuel,huͤtre,koͤńuͤ,uͤgekezetuel
Uͤ	Ü	Uͤduoͤzliǵ,[[3]]Uͤlvén,Uͤllyetek,Uͤdvoͤz-légy,[[19]]Uͤlvén,mōdván:Uͤdvoͤz-légy,Uͤdvoͤzloͤttek,járúlván,mon-da:Uͤdvoͤz-légy,Uͤdvoͤz-légy,Uͤdvoͤz-légy,Uͤdvoͤzítoͤ,
uͤˊ	ü	ſzuͤˊl,buͤˊnoͤkboͤˊl.,ſzuͤˊz,ſzuͤˊl:,ſzuͤˊlé:,oͤſzve-gyuͤˊjtvén,el-kuͤˊldvén,chillagot,oͤruͤˊ-lének,el-kuͤˊldvén,ágyéki-koͤruͤˊl:,Jordán-koͤruͤˊl-valo
uͤͤ	ü	uͤͤ,keſse-ruͤͤ
v̄	ü	<istev̄l>istentevl,tanitv̄áńommert,mv̄k-aidrvl,eſmerev̄kmenden,kev̄venek,kertev̄k,kēv̄,hyzzēv̄k
v̗	ü	kó̗ueteserv̗l:,v̗,v̗nekÿ,mindon-ostv̗lfoguan,v̗mondasa,v̗,v̗,alazatossagarv̗lmonduan,v̗,v̗,v̗
v̋	ü	kythv̋l,enthv̋lem,mynemv̋,yſtenttv̋l
ͮ	ü	lelkeͮnknek,tewtteͮk,tenneͮk,tenneͮkmeg,teͮttẏk,mẏbenneͮk,ezekkezeͮl,ellenſegiteͮl,erdeggekteͮl,regẏakneͮnec,teredelmeſſegͮel
v́̄	ü	mÿeretev́̄k
v̇	ü	neuv̇helyo̗n,keserv̇seges,azv̇tanmondanak,myndo̗nv̇t,v̇uo̗ltessel,v̇teh,v̇tek,v̇lni,v̇leh,v̇gi,abv̇nek
V́	Ü	V́,V́nekiktorkok,V́zto̗kben,V́tet,V́,V́ǵekeziel,V́,V́,V́lvente,V́tet,V́
v̗́	ü	v̗́,ÿv̗́ni,v̗́,v̗́,v̗́,v̗́,v̗́,v̗́magat,v̗́r,v̗́halalanac,v̗́
v́	ü	v́ket,v́tet,esv́,v́,valoembo̗ro̗ktv́l,ko̗no̗rv́le,v́,kv́,minemv́,v́,v́
v̈	ü	zv̈z,elmeyetv̈l,fv̈ſt,bev̈nt,zv̈ltvala,tev̈rettek,fōrdev̈,zv̈ltez,bv̈[ne]mket,lv̈lk[ön]ket,reteg[v̈]{108}{54v}[[]]{109}{55r}lölkonket
V̸	V	V̸gine{18}ees,V̸ſiculus,V̸ſiclus,V̸erſus,V̸ſiculusVeritas,V̸ſiculus,V̸eſiculus,viuiV̸ſiculus,V̸ſiculus,V̸ſiculus,V̸ſus
vͤ	ü	vͤldoͤznec,vͤldoͤſʒtéc,vͤldoͤznec,vͤtkoͤzénec,vͤtkoͤzzénec,vͤzé,vͤttoͤttet,vͤttoͤt-nec,vͤl,vͤzi,kivͤznéc
w̋	ü	enziw̋embeenziw̋embe,w̋nw̋n,w̋nw̋n,kÿbw̋l,vw̋twk,hw̋,vezedelemthw̋l,nekw̋nk,erekkw̋l,hw̋,felellw̋nk
ẇ	ü	keǵessegẇisten,szẇz,eẇt,kesserẇsege,eẇt,eẇt,eẇzue,eleẇ,eẇ,teẇre,dÿcheẇsegesistennek
ẃ̗	ü	megẃ̗,ẃ̗,hiẃ̗-sag,iẃ̗en-dó̗c,kẃ̗nec,ky̋ralleanẃ̗a
ẅ	ü	weredethnekẅnk,kesereẅseges,keserẅ-seges,keserẅseges,ÿe--rẅsalemeth,zẅz
ẃ	ü	ẃllʼenek,Senecaneẃ,vrẃ,eǵeb-nemẃ,nemíne--mẃ,ne--mínemẃ,eǵNemínemẃ,ńelʼẃ,y̋megbennemínemẃ,íllendẃ,Nemíne--mẃ
ẇ	ü	ozue-gyẇ̗l,meghsetetẇ̗lyo̗n
ẇ̗	ü	ozue-gyẇ̗l,meghsetetẇ̗lyo̗n
w̗	ü	zÿleietkeeryw̗k,kego̗tlenw̗l,tw̗zewel,mesto̗rw̗l,felÿw̗l,genÿe-rw̗,kego̗tle-nw̗l,merw̗ltetky,vero̗sw̗ltnek,nekw̗l,remenlÿw̗k
w̄	ün	minekw̄k,mondanw̄k,keelmínekew̄k,felÿw̄kistentwl,)lw̄k,mynekw̄k,meennyw̄k,erettew̄kpeldaat,wrw̄kIesusth,lakoznw̄kAzt,tw̄ÿasagbol
ẃ	ü	hẃ
w̋̄	ün	ÿdó̗keterthetw̋̄k
x̄	x	x̄p̄tus,x̄p̄tus,Iesusx̄p̄tus,x̄p̄us,x̄p̄us,x̄p̄us,x̄p̄sIrgalmaz,x̄p̄us,x̄p̄us,x̄p̄us,x̄p̄us
ẏ̄	i	bẏ̄hedni
ÿ	i	dorotÿa,Appalÿn,Matÿas,Gÿmo̗lch,leanÿad,vÿdf{10}{5v}g(a)b,vÿteezfg,kÿrald,Marghÿthfg,elÿees,zakadatÿad
ý	i	dýčo̗sege,Haýč,hýtmeg,raýta,ýmad--sagot,raýta,Kezdehaýat,Am<íý>el,kýwanſagal,kenweýben,beſtýeken
ÿ̄	i	eesmÿ̄den,mÿ̄dehatho,ÿ̄doitǎd,ÿ̄mar,banchatokhCÿ̄talan,menÿ̄wk,bÿ̄tesed,mÿ̄den,64vbaratÿ̄nak,mÿ̄dev́rev́ke,mÿ̄denkoron
ȳ	i	erdemȳnekteteliert,byneȳnek,lathatatlāellensegȳnek,chalardsagȳnacellene,ÿn-dulasȳnak,mȳd,belso̗ȳmel,mȳdenkoron,nȳomat,gondolatȳnak,bȳtẃl
Ÿ	I	eztendo̗be{271}{136r}Ÿth,Amen{359}{180r}(M)Ÿ,Ÿme,KŸ,zoo{62b}Ÿmaran,egÿ{86a}Ÿwtot,Ÿmaran,hÿttel{122a}Ÿmadaak,mondaewnekÿk{134b}Ÿme,:Ÿmaran,/Ÿaÿ
y̋	i	ky̋nec,Aty̋am,maǵarazy̋a,v́ray̋toc,ray̋tocal,akary̋a,by̋-neíert,istēnecfiay̋nac,fay̋dalmaertMind,ízy̋a,hy̋wseggel
y̋̄	i	my̋̄daz,my̋̄dezeketh,my̋̄d,my̋̄delthere,my̋̄dAkory̋g
ẏ	i	mẏhalc,ẏwan(a)b,har-mẏczeggh,Napẏae,kẏemlekozÿk,zẏveketh,Mẏnden,meghzẏwkseghÿnkbe,annẏaw<r>,expirauithelẏ,illet-neẏe
Y̋	I	Y̋euendo̗,Y̋saí--as
ź	z	hoźa,mihoźanc,hoźanc,źivek,emlekeźel,reźegsegben,źeǵelletekben,źem-eremsegben,vonźa,vźuen,vźo̗get
z̄	z	keūāz̄
ᶻ	z	magaztacᶻ,orcᶻaiarul,orcᶻaiat,ercᶻ,felecᶻ,ragacᶻ,magaztacᶻ,veccᶻ,kemencᶻe,orcᶻadnak,orcᶻaiokot
ʒ	z	nyolcʒ,keʒ-detijk.Elſew,nēʒetſegerewl,nemʒe,nemʒe,nemʒe,aʒ,nemʒe,ʒaramot,nemʒe,nemʒe
Ʒ	z	Ʒakarias,raijta.Ʒokas,Ʒent,lewnAuianus.{68r}Ʒent,nekijk.Ʒanomeʒ,Ʒebedeuſnak,nekijk.Ʒomorw,Ʒakarijas,Ʒakarijas,Ʒakarijaſt,ees,Ʒakarijaſnak
ꝯ	Pro	ꝯfeſſorra,Maſodzerꝯfirmallak,ꝯfesorodnak,ꝯfessorok,ꝯfessorokhEZekhez,mÿndꝯffesoroknak,ꝯfesoroknak,ꝯscienciam,ꝯpletaÿat,ꝯscienciaÿok,azꝯpletara
α	a	αmen,αmen,αmenkezdetik,αmen,αmen,αmen,αmen{118}{59v}Vrnak,αmenHarmad,αmenKezdetik,αmen{228}{114v}ez,αmen
